......
@..........
###..###...
...........
...###.....
...........
.###....###
...........
....####..
.........
..##....