......
..........#
########..#
..........#
@..########
..........#
#######.###
..###.....#
....####.#
........#
..##...#